111111111111111111111111111111111111111111111111111111111111
1X0000000000000000000000000000000000000000000000000000000001
111111111111111111111111111111111111111111111111111111111101
111111111111111111111111111111111111111111111111111111111101
111111111111111111111111111111111111111111111111111111111101
111111111111111111111111111111111111111111111111111111111101
111111111111111111111111111111111111111111111111111111111101
111111111111111111111111111111111111111111111111111111111101
111111111111111111111111111111111111111111111111111111111101
111111111111111111111111111111111111111111111111111111111101
111111111111111111111111111111111111111111111111111111111101
111111111111111111111111111111111111111111111111111111111101
111111111111111111111111111111111111111111111111111111111101
111111111111111111111111111111111111111111111111111111111121
111111111111111111111111111111111111111111111111111111111111
