111111111111111111111111111111111111111111111111111111111111
1X1111111111111111111111111111111111111111111111111111111111
101111111111111111111111111111111111111111111111111111111111
101110000000000000000011111111111111111111111111111111111111
100000111111111111111011111111111111111111111111111111111111
111111111111111111111011111111111111111111111111111111111111
111111111111111111111011111111111111111111111111111111111111
111110000000000000000011111111111111111111111111111111110001
111110111111111111111111111111111111111111111111111111110101
111110000000000000000000000000011111111111111111111111110101
111110111111111111111111111111011111111111111111111111110101
111110111111111111111111111111000000000000000000000011110101
111111111111111111111111111111111111111111111111111010000101
111111111111111111111111111111111111111111111111111000111121
111111111111111111111111111111111111111111111111111111111111
